. . . . . . . . # . . . . . . # . . . . 
1 2 # . . . . . # . . . . . . # . . . . 
# # # . . . . . # . . . . . . # . . . . 
. . . . . . . . # . . . . . . # . . r . 
. . r . . . . . # . . . . . . . . . . . 
. . . . . . . . . . . r . . . . . . . . 
. . . . . . . . . . . . . . # # # . . . 
. . . . r . . . . . . . . . . . # # . . 
. . . . . . . . # # # . . . . . . # . . 
. . . . . . . . # . . . . . . . . . . . 
# # # # # # . . # . . . . . . . # # # # 
. . . # . . . . # . . r . . . . . . . r 
. . . # . . . . # . . . . . . . # . . . 
. # . . . # . . # . . . . . . . # . . . 
